####################################
#SSSSS.............................#
#Srrr..............................#
#.rrr.......................rrrrr..#
#Sr.r.......rrrrrrrrr.......r...r..#
#Srrrrrrr...r......rrrrrrrrrrrrrrrE#
#Sr.....rrrrrrrrrrrr...............#
#.r.....r..........................#
#.rrrrrrr..........................#
#..................................#
#..................................#
####################################
