####################################
#PPP................MMMMMMMMMMMMMMM#
#P..............................MMM#
#P...............................MM#
#P.................................#
#............P.....................#
#..................................#
#............M.....................#
#...................O...........OOO#
#..............................OOOO#
#......................OOOOOOOOOOOO#
####################################
